type octile
height 7
width 19
map
...................
.@@..@@@@@@@@@@@@@.
.@@..@@@@@@@@@@@@@.
.@@..@@@@@@@@@@@@@.
.@@..@@@@@@@@@@@@@.
.@@..@@@@@@@@@@@@@.
...................
